###################    #################
#.................#    #...............#
#.................#    #...............#
#.....#######.....#    #....######.....#
#.....#     #.....#    #....#    #.....#
#.....#     #.....#    #....#    #.....#
#.....#     #.....#    #....#    #.....#
#.....#     #.....#    #....#    #.....#
#.....#     #.....#    #....#    #.....#
#.....#     #.....#    #....#    #.....#
#.....#     #.....#    #....#    #.....#
#.....#     #.....#    #....#    #.....#
#.....#     #.....#    #....#    #.....#
#.....#     #.....#    #....#    #.....#
#.....#     #.....#    #....#    #.....#
#.....#     #.....#    #....#    #.....#
#.....#     #.....#    #....#    #.....#
#.....#     #.....#    #....#    #.....#
#.....#     #.....#    #....#    #.....#
#.....#     #.....#    #....#    #.....#
#.....#     #.....#    #....#    #.....#
#.....#     #.....#    #....#    #.....#
#.....#     #.....#    #....#    #.....#
#.....#     #.....#    #....#    #.....#
#.....#     #.....#    #....#    #.....#
#.....#     #.....#    #....#    #.....#
#.....#     #.....#    #....#    #.....#
#.....#     #.....#    #....#    #.....#
#.....#     #.....#    #....#    #.....#
#.....#     #.....#    #....#    #.....#
#.....#     #.....#    #....#    #.....#
#.....#     #.....#    #....#    #.....#
#.....#     #.....#    #....#    #.....#
#.....#     #.....#    #....#    #.....#
#.....#     #.....#    #....#    #.....#
#.....#     #.....#    #....#    #.....#
#.....#     #.....######....#    #.....#
#.....#     #...............#    #.....#
#..x..#     #...............#    #..@..#
#######     #################    #######
